111111111111111111
100010MM001M0001E1
1000000MM00MMM0001
1000ECP0MM00M01101
100CC0M00MMM00M101
100M00MM00100MM001
11M1100M000000M101
100M00MM0010M00001
10M0E0M000M0E0M101
100M00MM00ME0C0M01
10M00M00MM0100M001
111111111111111111