1111111111111111111111111111111111111111111111111111111111
1000ECP00M000000000000000000000000000000000000000000000011
100000000M000000000000000000000000000000000000000000000011
100000000M000000000000000000000000000000000000000000000011
100000000M000000000000000000000000000000000000000000000011
10EEEEEE00000000000000000000000000000000000000000000000011
1000000000000000000000000000000000000000000000000000000011
1000000000000000000000000000000000000000000000000000000011
1000000000000000000000000000000000000000000000000000000011
1000000000000000000000000000000000000000000000000000000011
1000000000000000000000000000000000000000000000000000000011
1000000000000000000000000000000000000000000000000000000011
1000000000000000000000000000000000000000000000000000000011
1000000000000000000000000000000000000000000000000000000011
1000000000000000000000000000000000000000000000000000000011
1000000000000000000000000000000000000000000000000000000011
1000000000000000000000000000000000000000000000000000000011
1000000000000000000000000000000000000000000000000000000011
1000000000000000000000000000000000000000000000000000000011
1000000000000000000000000000000000000000000000000000000011
1000000000000000000000000000000000000000000000000000000011
1000000000000000000000000000000000000000000000000000000011
1000000000000000000000000000000000000000000000000000000011
1000000000000000000000000000000000000000000000000000000011
1000000000000000000000000000000000000000000000000000000011
1000000000000000000000000000000000000000000000000000000011
1000000000000000000000000000000000000000000000000000000011
1000000000000000000000000000000000000000000000000000000011
1000000000000000000000000000000000000000000000000000000011
1000000000000000000000000000000000000000000000000000000011
1000000000000000000000000000000000000000000000000000000011
1111111111111111111111111111111111111111111111111111111111